You're finally awake. You find yourself covered in darkness, smothered by the forces around you. Dazed, you try to sit up but there's something above you. You roll over to a side but there's something there too. Panicked, you look around blindly. You know you must press on to be free.
Maverick Bday
An Interactive Fiction by Tyler Jang and Mary Wang
Release 1 / Serial number 210416 / Inform 7 build 6M62 (I6/v6.33 lib 6/12N) SD

Darkness (in the coffin)
The grips of the coffin surround you. Your lungs fight to choke down air.

>push
(the coffin)
You shove the top of the coffin hard and it falls to the side easily.

Bedroom
Stepping out of the coffin, you turn in a circle, confused. You hear music and chatter coming from below, with stairs to the side.

You can see a stairs here.

>go down
Tavern
Somehow, you are in the middle of a dimly lit tavern, with a jolly minstrel playing a faint tune in the corner, and a dwarven bartender passing out drinks.  A hooded figure sitting at the bar counter glances at you briefly, but no one seems to notice the commotion.

Other than a tall oak door on the west wall, a dorm door to the north wall, and a heavy metal door to the east, there doesn't seem to be any other exits. You try to walk toward the oak door but stop when the dwarf glares at you.

Instead, looking around, you see a crackling fireplace by the wall. On each side, a suit of armor stalls tall, the metal glinting as the light shifts.

In the corner, a bookshelf sways haphazardly. Several books threaten to fall down above the minstrel, obliviously strumming away on what looks to be a hand harp.

You can also see a tall oak door, a stairs, a dorm door, a heavy metal door, Featherock, bartender and hooded figure here.

>go east
(first opening the heavy metal door)

Abyss
As you enter a pale blue chamber, the temperature seems to suddenly drop almost 10 degrees. The ghastly ghost of Gregor sits in the corner and exclaims: "Throw them into the abyss!" In front of you, on a narrow bridge, some characters appear to be fighting. A mural is seen on the far side of the room.
The metal door leads west back to the Tavern, and a highway leads east to Arizona.

You can see a heavy metal door, a highway, a mural and Gregor here.

>go east
(first opening the highway)

Arizona
As you get off the highway, you notice immediately that it's pretty cold, it's like 72 degrees, practically freezing.
The highway leads west back to the Abyss.

You see a laptop sitting on a desk just off the highway.

There is also a large black notebook lying on the desk next to the laptop. It isn't open, but appears to be labled Engineering.

There is a small robot sitting on the ground next to the desk, connected to the laptop by a long orange cable.

You can also see a highway and a desk here.

>look
Arizona
It is hot.
The highway leads west back to the Abyss.

You can see a highway here.

>search
(the highway)
You find nothing of interest.

* * *

>go east
(first opening the highway)

Arizona
As you get off the highway, you notice immediately that it's pretty cold, it's like 72 degrees, practically freezing.
The highway leads west back to the Abyss.

You see a laptop sitting on a desk just off the highway.

There is also a large black notebook lying on the desk next to the laptop. It isn't open, but appears to be labled Engineering.

There is a small robot sitting on the ground next to the desk, connected to the laptop by a long orange cable.

You can also see a highway and a desk here.

>examine the laptop
The laptop appears to have some code on it, it might do something cool, but it's doesn't have very many comments so who's to say.

>examine the laptop
The laptop appears to have some code on it, it might do something cool, but it's doesn't have very many comments so who's to say.

>examine the robot
Though simple, this robot looks quite functional. It should definitely work, yup. 100% guaranteed.

>examine the notebook
I wonder what could be written in it.

>open the notebook
It isn't something you can open.

* * *

>go east
(first opening the highway)

Arizona
As you get off the highway, you notice immediately that it's pretty cold, it's like 72 degrees, practically freezing.
The highway leads west back to the Abyss.

You see a laptop sitting on a desk just off the highway.

There is also a large black notebook lying on the desk next to the laptop. It isn't open, but appears to be labled Engineering.

There is a small robot sitting on the ground next to the desk, connected to the laptop by a long orange cable.

You can also see a highway and a desk here.

>open the notebook
You open the notebook, curious about what interesting designs it may hold...
None, there are no designs. There is, however, a key hidden in a compartment cut into the blank pages.

>i
You are carrying:
  a platinum key

>examine notebook
Yeah, this is probably the best use this has gotten.

>touch robot
As you start the program, the robot begins to move, the data stream on the laptop looks more or less nonsensical, but it traces a perfect square in the dirt, so the positional tracking system must work pretty well.

>touch laptop
You look on in pride as the robot makes another perfect loop.

>examine laptop
As you watch, the laptop's screen starts to turn a bright shade of pink as the code disappears behind the malfunctioning display.

>examine robot
This is a very good robot, should be eligible for some kind of award.

>touch notebook
You feel nothing unexpected.

>examine notebook
Yeah, this is probably the best use this has gotten.

>examine desk
You can't see any such thing.

* * *

>go east
(first opening the highway)

Arizona
As you get off the highway, you notice immediately that it's pretty cold, it's like 72 degrees, practically freezing.
The highway leads west back to the Abyss.

You see a laptop sitting on a desk just off the highway.

There is also a large black notebook lying on the desk next to the laptop. It isn't open, but appears to be labled Engineering.

There is a small robot sitting on the ground next to the desk, connected to the laptop by a long orange cable.

You can also see a highway and a desk here.

>examine the desk
On the desk are a laptop and a notebook (closed).

>look desk
On the desk are a laptop and a notebook (closed).

* * *

>push bookshelf
You give the bookshelf a hard shove and it topples over, falling onto the minstrel. With a screech, Featherock crumbles into a cloud of dust, his harp clanging to a rest on the ground.

>ask bartender about where I am
"Not bad," the dwarf said gruffly. "Here's an iron key. Take the oak door to the west to go camping. Take the heavy metal door to the east to adventure in the howling abyss. I'd recommend taking the dorm door to the north last. It's quite a party up there."

>go west
(first opening the tall oak door)

Forest
You enter a forest, filled with the oaken scent of woodsmoke. A man is crouched over a small fire, with goggles. The oak door leads back east to the Tavern and a path leads west to a Temple.

You can see a path, a tall oak door, a log, a golf club, a hatchet, a stick, goggled man and a hammock here.

>lay in hammock
You lay in the hammock, and a man in red comes to join you, because he's not gay. He gives you a bronze key.

>go west
(first opening the path)

Temple
You enter a grassy temple. A clock tower looms above you, tolling an evening tune. Without warning, discs start shooting out of the wall, crisscrossing in the room.
The path leads back east to the Forest.

You can see a path and a frisbee here.

>kick frisbee
The frisbee falls with a thud. What a block!
A key drops from below the disc.

>go east
Forest
You enter a forest, filled with the oaken scent of woodsmoke. A man is crouched over a small fire, with goggles. The oak door leads back east to the Tavern and a path leads west to a Temple.

You can see a path, a tall oak door, a log, a golf club, a hatchet, a stick, goggled man and a hammock here.

>go east
Tavern
Somehow, you are in the middle of a dimly lit tavern, with a jolly minstrel playing a faint tune in the corner, and a dwarven bartender passing out drinks.  A hooded figure sitting at the bar counter glances at you briefly, but no one seems to notice the commotion.

Other than a tall oak door on the west wall, a dorm door to the north wall, and a heavy metal door to the east, there doesn't seem to be any other exits. You try to walk toward the oak door but stop when the dwarf glares at you.

Instead, looking around, you see a crackling fireplace by the wall. On each side, a suit of armor stalls tall, the metal glinting as the light shifts.

In the corner, a bookshelf sways haphazardly. Several books threaten to fall down above the minstrel, obliviously strumming away on what looks to be a hand harp.

You can also see a tall oak door, a stairs, a dorm door, a heavy metal door, Featherock, bartender and hooded figure here.

>go east
(first opening the heavy metal door)

Abyss
As you enter a pale blue chamber, the temperature seems to suddenly drop almost 10 degrees. The ghastly ghost of Gregor sits in the corner and exclaims: "Throw them into the abyss!" In front of you, on a narrow bridge, some characters appear to be fighting. A mural is seen on the far side of the room.
The metal door leads west back to the Tavern, and a highway leads east to Arizona.

You can see a heavy metal door, a highway, a mural and Gregor here.

>gank mural
You gank the mural. The fight is won and the Priestess salutes you. A gold key falls from the sky. Suddenly, your pocket feels a little heavier. Peeking inside, you're shocked to discover exactly 3333 gold pieces.

>ask Gregor about Trinity Force
Gregor smiled wide, "Here ya go. To the victor go the spoils!"

>go east
(first opening the highway)

Arizona
As you get off the highway, you notice immediately that it's pretty cold, it's like 72 degrees, practically freezing.
The highway leads west back to the Abyss.

You see a laptop sitting on a desk just off the highway.

There is also a large black notebook lying on the desk next to the laptop. It isn't open, but appears to be labled Engineering.

There is a small robot sitting on the ground next to the desk, connected to the laptop by a long orange cable.

You can also see a highway and a desk here.

>go west
Abyss
As you enter a pale blue chamber, the temperature seems to suddenly drop almost 10 degrees. The ghastly ghost of Gregor sits in the corner and exclaims: "Throw them into the abyss!" In front of you, on a narrow bridge, some characters appear to be fighting. A mural is seen on the far side of the room.
The metal door leads west back to the Tavern, and a highway leads east to Arizona.

You can see a highway, a heavy metal door, a mural and Gregor here.

>go west
Tavern
Somehow, you are in the middle of a dimly lit tavern, with a jolly minstrel playing a faint tune in the corner, and a dwarven bartender passing out drinks.  A hooded figure sitting at the bar counter glances at you briefly, but no one seems to notice the commotion.

Other than a tall oak door on the west wall, a dorm door to the north wall, and a heavy metal door to the east, there doesn't seem to be any other exits. You try to walk toward the oak door but stop when the dwarf glares at you.

Instead, looking around, you see a crackling fireplace by the wall. On each side, a suit of armor stalls tall, the metal glinting as the light shifts.

In the corner, a bookshelf sways haphazardly. Several books threaten to fall down above the minstrel, obliviously strumming away on what looks to be a hand harp.

You can also see a heavy metal door, a tall oak door, a stairs, a dorm door, Featherock, bartender and hooded figure here.

>go north
(first opening the dorm door)

Nightclub
The party is lit. Everyone is vibing like there's no tomorrow. Some kid in the corner is doing the macarena. The DJ is the center of attention, keeping the music popping.
There is a dorm door leading back south to the tavern and a wooden door leading north.

You can see a dorm door, a wooden door, a metal bull, a mirror and DJ here.

>ask DJ about Everytime We Touch
What a banger! I'll put it on. Here's a diamond key for your troubles.

>go north
(first opening the wooden door)
It seems to be locked.

>exit
But you aren't in anything at the moment.

>quit
Are you sure you want to quit?

* * *

>go east
(first opening the highway)

Arizona
As you get off the highway, you notice immediately that it's pretty cold, it's like 72 degrees, practically freezing.
The highway leads west back to the Abyss.

You see a laptop sitting on a desk just off the highway.

There is also a large black notebook lying on the desk next to the laptop. It isn't open, but appears to be labled Engineering.

There is a small robot sitting on the ground next to the desk, connected to the laptop by a long orange cable.

You can also see a highway and a desk here.

>open notebook
You open the notebook, curious about what interesting designs it may hold...
None, there are no designs. There is, however, a key hidden in a compartment cut into the blank pages.
You take the Platinum Key from the notebook.

>go west
Abyss
As you enter a pale blue chamber, the temperature seems to suddenly drop almost 10 degrees. The ghastly ghost of Gregor sits in the corner and exclaims: "Throw them into the abyss!" In front of you, on a narrow bridge, some characters appear to be fighting. A mural is seen on the far side of the room.
The metal door leads west back to the Tavern, and a highway leads east to Arizona.

You can see a highway, a heavy metal door, a mural and Gregor here.

* * *

>go north
(first opening the wooden door)
It seems to be locked.

>i
You are carrying:
  a diamond key
  a platinum key
  Trinity Force
  a gold key
  a silver key
  a bronze key
  an iron key

>unlock wooden door
The door springs open with a click!

>go north
(first opening the wooden door)

Birthday
As you step inside, a stream of confetti falls down on you and a party hat drops on your head.

You walk forward and on the table in front of you is a cake with the words "Happy birthday!" on it. There is a knife and plate next to it.

You can also see a wooden door here.

>eat cake
(first taking the cake)
Happy birthday, Maverick! Congrats on turning 13!

    *** The End ***

Would you like to RESTART, RESTORE a saved game, QUIT or UNDO the last command?

* * *

You're finally awake. You find yourself covered in darkness, smothered by the forces around you. Dazed, you try to sit up but there's something above you. You roll over to a side but there's something there too. Panicked, you look around blindly. You know you must press on to be free.
Maverick Bday
An Interactive Fiction by Tyler Jang and Mary Wang
Release 1 / Serial number 210416 / Inform 7 build 6M62 (I6/v6.33 lib 6/12N) SD

Darkness (in the coffin)
The grips of the coffin surround you. Your lungs fight to choke down air.

>help
That's not a verb I recognise.

>actions
Actions listing on.

>help
That's not a verb I recognise.

>climb ladder / g
You can't see any such thing.

>climb ladder
You can't see any such thing.

>g
You can't see any such thing.

>hp
[hp]
You have 10 hit points!
[hp - succeeded]

>jump
[jumping]
Hippity Hoppity. You have more hp!
[jumping - succeeded]

>coffin
That's not a verb I recognise.

>touch coffin
[touching the coffin]
The void is… surprisingly soft. It feels suspiciously like styrofoam and hot glue?
[touching the coffin - succeeded]

>see
That's not a verb I recognise.

>look
[looking]
Darkness (in the coffin)
The grips of the coffin surround you. Your lungs fight to choke down air.

[looking - succeeded]

>inspect coffin
That's not a verb I recognise.

>see coffin
That's not a verb I recognise.

>look coffin
[examining the coffin]
You breathe in and breathe out. When you calm down enough to look around you, you notice that it isn't as dark as you thought. As your eyes adjust, you look down and - wait, is that your bed?

[examining the coffin - succeeded]

>player
That's not a verb I recognise.

>where am i
That's not a verb I recognise.

>i
[taking inventory]
You are carrying nothing.

[taking inventory - succeeded]

>search coffin
[searching the coffin]
The coffin is empty.

[searching the coffin - succeeded]

>push
(the coffin)
[pushing the coffin]
You shove the top of the coffin hard and it falls to the side easily.

[(1) looking]
Bedroom
Stepping out of the coffin, you turn in a circle, confused. You hear music and chatter coming from below, with stairs to the side.

You can see a stairs here.

[(1) looking - succeeded]

[pushing the coffin - succeeded]

>go down
[going down]

Tavern
Somehow, you are in the middle of a dimly lit tavern, with a jolly minstrel playing a faint tune in the corner, and a dwarven bartender passing out drinks.  A hooded figure sitting at the bar counter glances at you briefly, but no one seems to notice the commotion.

Other than a tall oak door on the west wall, a dorm door to the north wall, and a heavy metal door to the east, there doesn't seem to be any other exits. You try to walk toward the oak door but stop when the dwarf glares at you.

Instead, looking around, you see a crackling fireplace by the wall. On each side, a suit of armor stalls tall, the metal glinting as the light shifts.

In the corner, a bookshelf sways haphazardly. Several books threaten to fall down above the minstrel, obliviously strumming away on what looks to be a hand harp.

You can also see a tall oak door, a stairs, a dorm door, a heavy metal door, Featherock, bartender and hooded figure here.

[going down - succeeded]

>look
[looking]
Tavern
Somehow, you are in the middle of a dimly lit tavern, with a jolly minstrel playing a faint tune in the corner, and a dwarven bartender passing out drinks.  A hooded figure sitting at the bar counter glances at you briefly, but no one seems to notice the commotion.

Other than a tall oak door on the west wall, a dorm door to the north wall, and a heavy metal door to the east, there doesn't seem to be any other exits. You try to walk toward the oak door but stop when the dwarf glares at you.

Instead, looking around, you see a crackling fireplace by the wall. On each side, a suit of armor stalls tall, the metal glinting as the light shifts.

In the corner, a bookshelf sways haphazardly. Several books threaten to fall down above the minstrel, obliviously strumming away on what looks to be a hand harp.

You can also see a tall oak door, a stairs, a dorm door, a heavy metal door, Featherock, bartender and hooded figure here.

[looking - succeeded]

>look bookshelf
[examining the bookshelf]
Just floorboards. Nothing interesting here, nope.

[examining the bookshelf - succeeded]

I beg your pardon?

>look bookshelf
[examining the bookshelf]
Still just floorboards. From the corner of your eye, you see the other customers looking at you funny.

[examining the bookshelf - succeeded]