You're finally awake. You find yourself covered in darkness, smothered by the forces around you. Dazed, you try to sit up but there's something above you. You roll over to a side but there's something there too. Panicked, you look around blindly. You know you must press on to be free.
Maverick Bday
An Interactive Fiction by Tyler Jang and Mary Wang
Release 1 / Serial number 210415 / Inform 7 build 6M62 (I6/v6.34 lib 6/12N) SD

Darkness
The grips of the coffin surround you. Your lungs fight to choke down air.

If only you could see properly...

>examine coffin
You breathe in and breathe out. When you calm down enough to look around you, you notice that it isn't as dark as you thought. As your eyes adjust, you look down and - wait, is that your bed?

>touch coffin
The void is… surprisingly soft. It feels suspiciously like styrofoam?

>push coffin
You shove the top of the coffin hard and it falls to the side easily.

Tavern
Stepping out of the coffin, you turn in a circle, confused. Somehow, you are in the middle of a dimly lit tavern, with a jolly minstrel playing a faint tune in the corner, and a dwarven bartender passing out drinks.

Looking around, you see a crackling fireplace by the wall.

In the corner, several books threaten to fall down above the minstrel.

* * *

You're finally awake. You find yourself covered in darkness, smothered by the forces around you. Dazed, you try to sit up but there's something above you. You roll over to a side but there's something there too. Panicked, you look around blindly. You know you must press on to be free.
Maverick Bday
An Interactive Fiction by Tyler Jang and Mary Wang
Release 1 / Serial number 210415 / Inform 7 build 6M62 (I6/v6.34 lib 6/12N) SD

Darkness
The grips of the coffin surround you. Your lungs fight to choke down air.

If only you could see properly...

>push coffin
You shove the top of the coffin hard and it falls to the side easily.

Tavern
Stepping out of the coffin, you turn in a circle, confused. Somehow, you are in the middle of a dimly lit tavern, with a jolly minstrel playing a faint tune in the corner, and a dwarven bartender passing out drinks. A hooded figure sitting at the bar counter glances at you briefly, but no one seems to notice the commotion.

Other than a small door behind the bartender, there doesn't seem to be any exits. You try to walk to the side to peek around the dwarf but he glares at you. Stopping, your eyes glance down at the key on his necklace, and he growls at you. "I'm trying to work over here. What do you want?"

Instead of responding, you look around and see a crackling fireplace by the wall. On each side, a suit of armor stalls tall, the metal glinting as the light shifts.

In the corner, a bookshelf sways haphazardly. Several books threaten to fall down above the minstrel, obliviously strumming away on what looks to be a hand harp. Next to the minstrel, there is a piece of paper tacked to the wall next to him, with the name "Featherock" in bold font. Why does that name sound so familiar?

You can also see a Featherock, a bartender and a hooded figure here.

>ask bartender
You can't see any such thing.

* * *

>ask bartender about exit
You can't see any such thing.

>ask bartender
You can't see any such thing.

* * *

>examin tavern
That's not a verb I recognise.

>examine Tavern
You can't see any such thing.

>examine tavern
You can't see any such thing.

* * *

>examine Tavern
You can't see any such thing.

>examine
What do you want to examine?

>look at Tavern
You can't see any such thing.

* * *

>examine bartender
You can't see any such thing.

>examine the bartender
You can't see any such thing.

>look
Tavern
Stepping out of the coffin, you turn in a circle, confused. Somehow, you are in the middle of a dimly lit tavern, with a jolly minstrel playing a faint tune in the corner, and a dwarven bartender passing out drinks. A hooded figure sitting at the bar counter glances at you briefly, but no one seems to notice the commotion.

Other than a small door behind the bartender, there doesn't seem to be any exits. You try to walk to the side to peek around the dwarf but stop when he glares at you.

Instead, looking around, you see a crackling fireplace by the wall. On each side, a suit of armor stalls tall, the metal glinting as the light shifts.

In the corner, a bookshelf sways haphazardly. Several books threaten to fall down above the minstrel, obliviously strumming away on what looks to be a hand harp.

>ask the bartender about exit
You can't see any such thing.

>ask the bartender about "exit"
You can't see any such thing.

>ask bartender about "exit"
You can't see any such thing.

>ask bartender about exit
You can't see any such thing.

* * *

>examine bookshelf
Just floorboards. Nothing interesting here, nope.

* * *

>examine fireplace
Weird, you could have sworn there was a fireplace here, but all you see are floorboards. Feels a little warm though.

>examine tavern
You can't see any such thing.

>examine fireplace
Ouch, that's hot! Maybe we shouldn't keep looking closer...

>examine bookshelf
Still just floorboards. From the corner of your eye, you see the other customers looking at you funny.

* * *

>look
Tavern
Stepping out of the coffin, you turn in a circle, confused. Somehow, you are in the middle of a dimly lit tavern, with a jolly minstrel playing a faint tune in the corner, and a dwarven bartender passing out drinks. A hooded figure sitting at the bar counter glances at you briefly, but no one seems to notice the commotion.

Other than a small door behind the bartender, there doesn't seem to be any exits. You try to walk to the side to peek around the dwarf but stop when he glares at you.

Instead, looking around, you see a crackling fireplace by the wall. On each side, a suit of armor stalls tall, the metal glinting as the light shifts.

In the corner, a bookshelf sways haphazardly. Several books threaten to fall down above the minstrel, obliviously strumming away on what looks to be a hand harp. There is a piece of paper tacked to the wall next to him, with the name "Featherock" in bold font.

You can also see Featherock, Hooded Figure and Bartender here.

* * *

>push bookshelf
You give the bookshelf a hard shove and it topples over, falling onto the minstrel. With a screech, Featherock crumbles into a cloud of dust, his harp clanging to a rest on the ground